...............................................
...o...o...o...o...o...o...o...................
...a...a...a...a...a...a...a...................
...a...a...a...a...a...a...a...................
...c...c...c...c...c...c...c...................
...c...c...c...c...c...c...c...................
...............................................
...............................................
...............................................
...............................................
...............................................
...............................................
...............................................
...............................................
